0 0 0 0 0 0 0 0 0 0 
0 1 0 0 0 0 0 0 0 0 
0 1 0 0 0 0 0 0 0 0 
0 1 0 0 0 0 0 0 0 0 
0 1 0 0 0 0 0 0 0 0 
0 1 0 0 0 0 0 0 0 0 
0 1 0 0 0 0 0 0 0 0 
0 1 0 0 0 0 0 0 0 0 
0 1 0 0 0 0 0 1 1 1 
0 1 1 1 1 1 1 1 1 1 
16
1 1
2 1
3 1
4 1
5 1
6 1
7 1
8 1
9 1
9 2
9 3
9 4
9 5
9 6
9 7
8 7
15.00