0 0 0 0 0 0 0 0 0 0 
0 0 1 1 1 1 0 0 0 0 
0 0 1 0 0 1 0 0 0 0 
0 0 1 1 0 1 0 0 0 0 
0 0 0 1 0 1 1 1 0 0 
0 0 0 1 1 1 0 1 1 1 
0 0 0 1 0 0 0 0 0 1 
0 0 0 0 0 0 0 0 0 0 
0 0 0 0 0 0 0 0 0 0 
0 0 0 0 0 0 0 0 0 0 
13
1 2
1 3
1 4
1 5
2 5
3 5
4 5
4 6
4 7
5 7
5 8
5 9
6 9
12.00